12
6
111111111111
100000000001
100000000001
1000e0000001
100000000001
110111111111
