8
6
11011111
100000@1
10100001
10000001
10000001
11111111
