8
6
11 11111
1      1
1 1    1
1   @  1
1      1
11111111
